1111111111111
1E010000010C1
1000011111001
1P0011C000001
1111111111111
