1111111111111111111111111111111111
1E00000000F0000C000F0C000000000001
1010010100100000101001000000010101
101001001010101000100100000001F101
1P0000000C00C00000000000F0000000C1
1111111111111111111111111111111111
