1111111111
1P00CCC0E1
1111111111
