11111111111111
1P000000000001
100000C0000001
100000C0000001
100000C0000001
100000C0001001
100000000000E1
11111111111111
