11111111111111
1P000000000001
100000CC000001
100000CC000001
100000CC000001
100000CC000001
100000000000E1
11111111111111
